IIIIIIII
IMMMMMMI
IM s  MI
IM    MI
IMd  dMI
IM  S MI
IMMMMMMI
IIIIIIII