IIIIIIII
IMMMMMMI
IM s pMI
IDDD  MI
IDdD dMI
IDDD SMI
IMMMMMMI
IIIIIIII